6
16
7
7
4,4,4,4,4,4,9,
4,5,7,6,4,4,20,
13,4,18,11,8,13,20,
20,5,18,10,10,10,16,
14,4,15,11,16,4,4,
4,5,12,19,4,4,4,
2,2,2,1,2,2,2,

0,0,0,0,0,0,0,
0,0,0,0,0,0,3.d1_n1_killed,
1.d1_feather,0,0,1.d1_nightmarekey,0,1.d1_beak,0,
0,0,1.d1_r20,1.d1k3,0,0,0,
0,0,0,1.d1k2,1.d1_map,0,0,
0,0,0,0,0,0,0,
0,0,0,0,0,0,0,

1
d1_wall,2,3,17